1 1 1 1 1 1 1
1 7 7 2 2 2 1
1 6 7 2 2 3 1
1 1 1 1 1 3 1
1 0 0 2 2 2 1
1 5 0 2 2 2 1
1 1 1 1 1 1 1